[
['1', '1', '1', '1', '1', '1', '1', '1', '1', '1', '1', '1', '1', '1', '1', '1', '1', '1'], 
['1', 's', '0', '0', '0', '0', '1', '0', '0', '0', '0', '0', '0', '1', '0', '0', '0', '1'], 
['1', '0', '1', '0', '1', '0', '1', '0', '1', '0', '1', '1', '0', '0', '0', '1', '0', '1'], 
['1', '0', '1', '0', '1', '1', '1', '0', '1', '0', '0', '0', '1', '1', '1', '0', '0', '1'], 
['1', '0', '0', '1', '0', '0', '0', 'i', '0', '1', '1', '0', '1', 'x', '1', 'd', '1', '1'], 
['1', '1', '0', '0', '1', '0', '1', '1', '1', '0', '0', '0', 'x', '2', '1', '0', 'e', '1'], 
['1', '0', '0', '1', '1', '0', '1', '0', 'c', '1', '0', '1', '0', '1', '1', '1', '1', '1'], 
['1', '0', '1', '0', '0', '0', '1', '1', '0', '1', '0', '0', '0', '0', '0', '0', '0', '1'], 
['1', '0', '0', '0', '1', '0', 'b', '0', '0', '1', '0', '1', '1', '1', '1', '0', '1', '1'], 
['1', '1', '0', '1', '1', '0', '1', '0', '1', '0', '1', '0', '0', '0', '1', '0', '0', '1'], 
['1', '0', '0', '1', '0', '0', '1', '0', '1', '0', '1', '0', '1', '0', '0', '1', '0', '1'], 
['1', '0', '1', '1', '0', '1', '0', '0', '0', '0', '0', '0', '1', '1', '0', '1', 'c', '1'], 
['1', '0', '1', '0', '0', '1', '0', '1', '0', '1', '1', '1', '0', '0', '0', '1', '0', '1'], 
['1', '0', '0', '1', '0', '0', 'f', '0', '0', '1', '0', '0', '0', '1', '1', '3', 'x', '1'], 
['1', '1', '0', '1', '1', '1', '0', '1', '0', '1', '0', '1', 'g', '1', '1', 'x', '1', '1'], 
['1', 'a', '0', '1', 'x', 'x', 'x', '4', 'x', 'x', 'x', 'h', '0', '0', '0', 'x', '0', '1'], 
['1', '1', '1', '1', '1', '1', '1', '1', '1', '1', '1', '1', '1', '1', '1', '1', '1', '1']
]